 ,::::::,,,,,,,,,:::::::::::,,,.,..,,:::,:;;;;;;+;;;:::;;::::::::::::,;;;;*
 ,:,,,,,,,,,,,,,:,,,,,,:::::::::::::,,,,;+;::::::+*;:::::;+*++:::::,,.+:+:?
 ,,,,,,,,,,,,,:,,::;;;+;;;:::;;;;:;;;+;+;..,,,,,,,:,,:;,,:::::,::;::,.+:+:%
 ,:,,,,,,,,,,,;,:+:,,,,,,,:::,,,,,...,*?.,,,,:;,;,,:;::;::,,:::::*:,,,*:;:%
 :*::::;,,,,,::.;+,..:;,,,,;:,,,,,::,,*+:,,,,,,::::;,,:,,,,,,,,,,*;,,,*,;;%
 :*:+;:+,,,,,;,.;+,;;:,;:,,::::::,,:::%;::,,,;::::;;+++++*;::,,:;+,,,,*:;;?
.:+,+:,+,,,,:+,.++,::::::::::;::,,:::*%:,,,,:;,::+*;:;+++??;,,,:*,,,,,*:;:*
.:;,;::+,,,,:;,,*;,,,::::::,,,,,::,,,*?:;,,,::::++,::,++;++;+::+:,,,,,;,;:*
.:+,;:,+,,,,::,,*:,,,,,,,,,,,,::::::,*?,,,;:,::;?;:,,;;.,::::;;;::,,,,+:;:?
.:;,;;,;,,,,;:,,++::::,,,,,:::;:::;,.;*::;;;:;+?+.,,;*:,,:.,:.,*,,,,,,*:;;?
.:+,;;,+,,::::::,:+*;:::,:;::,:;+::;:+?;++++;;;:;;;*?:;+;;::::;*,,,,,,+;*;*
.:*,;;,+,,::::::,,,+?+:::::;;;:;*:::;?;;;,,,::,::;::++,:::;:::,+:,,,,,*,,:?
.:;,::,*:,,,::,,,,,++;+;;;+;:,,,,;;:?:,,:,,;;;;;,,,,:++,,:::,:,;+,,,,,*,,:?
.,,,,,:+,,,,;:,,,:+:,,,:;,;,::,;;,,;+,:,:;::,,;;,,,,.;:::,,;::,:*,,,,,;::;?
.:,,,,:+:,,,;,,,:+,,,,::,::;::::::,:*::::::,:;,::,,,,*;;;;;;;;;;*;:,,,,,,,+
.:,,,,:*,,,,;,,,*:,,;:,::,:;;::,,:;.;?:;::,,,:,+*;;;;:,,,,,,,,::;*:,,,,,,,*
,:,,,,:+,,,,;,,,*,,;,,,::,,;:::::,:;+*::;+;+;::::+.,,,,,,,,,,,,,,*,,,,,,,,*
.:,,,,:;,,,,;,,,+;:::+;,,,,:,,,,,,:*:::,,:+::,..;;.,,,,,,,,::::::*;:,,,,,,*
.:,,,,:*:,,,;,,:;+;,::::,,,,,,,,:;;::,:;:;;:;;,.*::,,,,,,:;:;,,,;+,,,,,,,,*
.:,,,,:;,,,:;,,,,,?:,,:+::;;::,+;,:::;:;,,,,,:,,+:+,,,,,:;,:+:,,+;,,,,,,,,*
,:,,,,,,,,,:+,,,,++;::::;:::,,++,,;+:::;,,,,,:;?:,:,,::;::::,:,,;+,,,:,,,,*
,:,,,,,,,,,,;,,,+:,,,::;:;;;;;;:;;:,:::;;:::;+*%+::;::::,;+:,:,,:?:,,,,,,,*
,:,,,,,,,,,,;,,,+,,,,,,,,,,,,,,,,:;;;;;::::::::*+:;+,,,:::::::,,:*,,,,,,,,*
,:,,,,,,,,,,;:,,;;,,,,,,,,,,,,,,,,,,,,,;+;,,,,,:*::;,,,:::::,,,:*:,,,,,,,,*
,:,,,,,,,,,,;:,,:*,,,,,,,,,,,,,,,:*:,,,,,++;::,;*;++::::::,,,,,*:,,,,,,,,,*
::,,,,,,,,,,;:,,:+,,,,,,,,,,,,,,,:*;,:,,,,::;;;:::+*,,,::::::,+;,,,,,,,,,,*
::,,,,,,,,,,::,,+:,,,,,,,,,,,,,,,,,,,:,,::,,,,,,,,,++,,,,,,,,+*,,,,,,,,,,,?
::,,,,,,,,,,,;:,+;,::,:::,,,,,,,,,,:::,:::,,:,,,,,,,;+;;;,,:;;,,,,,,,,,,,:?
::,,,,,,,,,,,,::,:;;;;;:;+;;;:::;++;;*,,,,,*+;;;;;;;;;;;;:;;:,,,,,,,,,,,,*?
::,,,,,,,,,,,,,;;,,,,,,,,,:::;;;:,,,;+,::,,;*,:::::,,,,,,,,,,,,,,,,::,,,:;*
:::::::;;:::::::;+:::;;:;;;;;::;;:::;;,,,,,::,,,,,,,,,,,,,,,,,,,,,,,,,,,,..
