......................,.............::............:;:........        ......
.....................:::...........,;*: ..........;+;........,,,.,,,,......
.............................................................,,,,,,,,......
...........................................................................
...........................................................................
...........................................................................
..........,,.......................................:::,....................
...........................................,:.......:. .....:, ............
.............................,,...,,... ...............,:..........,:... ..
.............................::,,:::..,,. .........   .............,:..,,..
.....................,..........::;,,,::,,.........,,,....... ,:, .. ......
...............................,,,:,:,,,,..........+++, .....,..,..........
.................................:.:,....,........,;;;,....,::,,,,...,.....
...... ....... ....................,...:::,..,,. ............:.,...........
.....,::,....,,...............:,.,..::,:....................... ....... .,:
..........,,.,,,.. ...,,.........,.... .:.......,,,...............  ...... 
..........,,.....,,.............,,.....,::........................:,.......
..........  ,,...,,.............,,...::::.............,....................
............,:...  ..................,:::,....... ... ........,:,..........
.............,...............................,...,...,..................,..
..............,,..........,.................................,. .,..........
..............,.............................................,.,,;..........
..............:...............................................,,...........
.......................             ...              ......................
