%%?**++;::,,,,,,,,,,,,,,,,,,,,,,,,,,,:,,,,,,,,,,,,,,,,,,,,,,,,,,,,::;+*?%##
#%???**++;:::::::::::::::::::::::::::;::::::::::::::::::::::::::::;;+**?%##
#%%??**+++;;:::;:::::;:::::::::::::::*;:::;:::::::::::::::::;::::::;+?*?###
#%%??*+;;::,,,,::,::::,,,,,,:,,,,,::,+,,,:,::::,,:,,,,,;;:,,:,,,,,:;+*??###
#%%??*+;;::,,,:::;::::,,,,,,;,,,,,,:,:,::,,,,::;;++:,::;::,,,,,,,:;;+**?%##
#%%?**+;;::::::::+;:::::,,,,:,,,,,,;,:,::,::;;;;:,:::,,::,,,,,,,,:;;+*??%##
#%%?**++;;;:::::,,::::,,,,,,,,,,:::::;:::,,,;;;,,,:::::::::,,:,,,,:;+???%##
#%%?****;;;::,,,;::;::,,,,,,,:;;;;::;+::,,,;;;,::,,,:,,;;;,,,;::,,:;+?*?###
#%%?***+;::,,,,::,:*+;,,:+;:;::,,;:;;+:::,,:;:,::,,;:;::;+;:::::,,:;*???%##
#%%?***+;::,,,,,:,,;;;;;;;,;;.,,::,+,+;::,,;;;,::,:;:;;:,,;,:::;:,:;*???%##
#%%??*++;:::,,,:;,,,,,,,,:+*:,,,,::+,+:::,,,,::;:,,:,::;+:;:;;;;:::;+???%##
#%%??*++;;;;;:,,:::::::::,:+:,,,::;;,;::,,,,,,::::,,,::;;:;:;;:,:::;+*??%##
#%%??*++;:;;,,,,;+*,,::::::+,::::+;,,;+,,,,,,,,:,,,,,:;::::,,,:;,::;+*??%##
#%%??***;:::,,,,,::,,,::,:;+::;::,,,,;+:,,::,,:;,::,,;;:,:;,,,:;:;;++**?%##
##%?***;;:,,,:,,..,,,,,,:,:+,,:::,:,,++:,,+++.,::;;:::;;;:::,,:::::;+??%%##
##%??*+;;::,,;:,,,,,::,,,,;:,,,:,,,,,+;,,,,,,,::::::::::,,,,,,,:+*+;**?%%##
##%%?*++;:::,:+,,,,:::,,,,+,:,,,..,::;;:,,,,,::::;::,,::,,:::,,,,::;**?%%##
##%%?*++;::,,.,;:::::;::::;,,,,,,;:,,*+,:;;:+:::;+,:.,;:,,:::,,,,;;;++*?%##
##%%?*+++::,,,.,::;::,,,,,;:,,,.,+,,;;;;+;:,;,,:,+:,,:;:,,,::,,::+;;***?###
##%%?*++;:::,,,,,,,,..,;;:::,,,.,:,;;++;;:,;;,,::+:.,:;;,,:;;,::;;:;+**?###
##%%?*+;;::;:,,,,,,::,,:;:;:,:,,,:,::+*+::;:,,:;;:+,,,:;,+++:::+;:+;;+*?%##
###%??++;;:+,,,,,,:::::,,:;;,,,::;::,;*+,;,,:;;;:,:;:,,;::::::;;:;;+***?%##
###%??*+++:+:::,,,,,::,,,,;:,:,,::,:,;;;;+;::,,;;:,;+::::::::;;;;;;+***?%##
###%??++;;:;;,,,,,,,,,,,::;:,,,,:;::,;++;++*,,,::::;,:::::::::;;;;;;**??%##
###%%?*+;;:;;:::,,,,,,,,::;:,,,,::,:,+;;::::,,,:,,,,,:::;::,::+;:;+++**?###
###%%??*+++;;:;;;::::::::::::::::::::*+;;::::;:::::::::;::::::;;;+++**??###
###%%?*++;;:::,,,,,,,,,,,,,:::,,,:::,;;:::,::::::::::,::,::::::::::;+**?%##
