;::::;;;;;;;;;;;;;;;;;;;;;;;;;;;;;;;;;;;;;;;;;;;;;;;;;;;;;;;;;;;++;;;;;;;;;
++++++++++++;;;;;;;;;;;;;;;+;;;+;;;;+++;;++;;;;;++;;+;;++++;;;;+++;;;;+++;;
;;;++++++++++++++;+++;++++++;;+++;+++++;;+++;+;;++++++;++++++++++++++++++;;
;;;++++++++++++++++++++++;+;;;++++*;;+*++++++++;;++;;+++;+++*****?****+;+;;
;;;+++++++++++++++++++++;;++;;*++*+;+;+**++*++++++++++++++++**?**?*+++++++;
;;;++;;+++++;++++++++++++++++++*?+*+*++?*++;+++;;++;;++;+;++++***+++++;;++;
+;;+++++++++;++++++++++++++++++++++++++*+++++++;+++++++;++*+;+++++++++++++;
;;;+++++;+++;;;*++++;+++;+++++;++*++++*+;*+;+++;+++;++++++++;+;+++;++++++++
+;;++;++;;++++**;+++;;++;;;+;;+;++++++++;++;;++;;+;+++++;++;;+;;++;;++;+++;
+;;++++;;++++;++;;;++;+++;+++;+++++;+++++++;++++++++++++;+++;+++++++++++++;
+;;+;++;;++++++++++++*+++;++;;+++;+;+++++;+++++;;+++;++++++++*;+++++++++++;
;;;+++++++;++++++++++*;+++++;;+++++++++++++++++;;++++++++++;++;;++++++++++;
;;;++*++***;++++**++;+++;+*++;+++*++*+++*?++**+++++;;++;+++*++*++?*+*++;++;
;;;++++;+++;;;**++++++;+++++++*+++++++++***++*+++++;+++++++*+++++**+++++++;
;;;++;++;;+++**++;++++++++;+?**?+++++**+++*+++*+++++;+++;+*+++;;;;+*+++++++
;;;++++++++++??+++**++++++++**++***?+++++++++++++++++++++**+++++++++++++++;
;;;+;;;+;;+++?%?+++++++++;++;+;++++%?+++;++;;++;;++;;+++++;;;+++++++++++++;
;;;++++++;++*?%?*++++++++++;;++++*******;++++++++++++++;++++++++++++++++++;
;;;+;++++++++++*?**?***+++++++*+?%++++++++++++++;+++;+;;;+;;;+;;;+;;++;+++;
;;;+++*****++++*?+**++*??????*???*+*+*++*++++++++*++++++++;+++++++++++++++;
;;;+****++**+*+++++++++++++++++++?*++***+*?++*++*++++++;++;+;+;;++++++;+++;
;;;+*+**+****+***++++++++++++++++**;+++++++*?*++++++++++++++;+++++++++++++;
;;;+***+*?+?*****++++++++++++**+;;++++++++*+*++++++++?++++++;++;;++++++;++;
;;;+****************++++++++**+;;;;+++++**+++**++++**+;+++++++;;;++;++;;++;
;;;+++**+*+**+*********+++*+++;+++++++++++++++*++++*++++++++++++;+++++++++;
;;;++;+++;;++;++;++++++;++++++++++++;;+;+++;;+++;;++;;++++;++;++++++++++++;
;;;;;;;;;;;;;;;;;;;;;;;;;;;;;;;;;;;;;;;;;;;;;;;;;;;;;;;;;;;;;;;;;;;;;;;;;;:
